1222222222222222222222222222222222222221
3000000000000000000000000000000000000004
3000000000000000000000000000000000000004
3000000000000000000000000000000000000004
3000000000000000000000000000000000000004
3000000000000000000000000000000000000004
3000000000000000000000000000000000000004
3000000000000000000000000000000000000004
3000000000000000000000000000000000000004
3000000000000000000000000000000000000004
3000000000000000000000000000000000000004
3000000000000000000000000000000000000004
3000000000000000000000000000000000000004
3000000000000000000000000000000000000004
3000000000000000000000000000000000000004
3000000000000000000000000000000000000004
3000000000000000000000000000000000000004
3000000000000000000000000000000000000004
3000000000000000000000000000000000000004
3000000000000000000000000000000000000004
3000000000000000000000000000000000000004
3000000000000000000000000000000000000004
3000000000000000000000000000000000000004
3000000000000000000000000000000000000004
1555555555555555555555555555555555555551
